1111111111111111111111111111
1P1CC00000000000000000000001
101CC00000001111111111000001
1C11101111111000000CC1000001
1000001000000000000CC1000101
1011111011111111111111000101
1010000010000000000000000101
1010111110111111111111111101
1010100000100000000000000001
1010101111101111111111111111
10C010000C10CCCCCCCCCCCCCCE1
1111111111111111111111111111
