111111111
1P00000E1
100000011
1C0000C01
111111111
